#tileset
tileset1.bmp
8 1
tile0: ciel
tile1: mur
tile2: mur
tile3: mur
tile4: mur
tile5: mur
tile6: mur
tile7: mur
#level
15 13
1 1 1 1 1 1 1 1 1 1 1 1 1 1 1
1 0 2 2 2 0 2 2 2 0 2 2 2 0 1
1 0 1 0 1 2 1 0 1 2 1 0 1 0 1
1 2 2 2 0 2 2 2 2 2 0 2 2 2 1
1 0 1 0 1 2 1 0 1 2 1 0 1 0 1
1 2 2 2 0 0 2 2 2 0 0 2 2 2 1
1 0 1 0 1 2 1 0 1 2 1 0 1 0 1
1 2 2 2 0 2 2 2 2 2 0 2 2 2 1
1 0 1 0 1 2 1 0 1 2 1 0 1 0 1
1 2 2 2 0 2 2 2 2 2 0 2 2 2 1
1 0 1 0 1 2 1 0 1 2 1 0 1 0 1
1 0 2 2 2 0 2 2 2 0 2 2 2 0 1
1 1 1 1 1 1 1 1 1 1 1 1 1 1 1
